0 11 0 0 11 0 11 0
0 21 12 12 3 12 3 12
0 11 0 0 11 0 11 0
12 3 12 12 23 0 21 12
0 11 0 0 11 0 11 0
0 11 0 0 11 0 11 0
12 3 12 12 3 12 22 12
0 11 0 0 11 0 0 0
0 21 12 12 22 12 24 12
0 11 0 0 0 0 11 0